311	318	313	312	310	315	307	356	314	
313	318	312	311	310	315	314	356	
312	309	318	313	311	310	317	315	307	356	355	306	314	
304	308	318	301	302	303	316	305	317	106	482	356	406	405	404	410	402	409	
209	201	203	202	205	204	210	211	206	227	228	207	212	
206	201	203	202	205	204	207	211	209	208	210	226	227	212	
208	212	207	206	227	226	205	
212	210	207	211	209	208	206	228	227	226	205	
226	212	210	207	211	208	206	228	227	205	
317	308	309	305	318	304	302	303	316	306	314	356	355	315	312	307	
309	308	318	312	302	303	317	316	306	314	355	315	307	
306	308	309	310	301	302	303	317	316	307	355	312	314	
404	301	304	305	407	406	405	403	402	401	408	409	482	481	480	
414	356	484	483	410	
211	203	202	212	207	210	206	209	228	227	226	205	204	
480	404	403	402	401	481	
318	308	309	313	317	311	303	304	316	315	305	314	482	484	355	356	405	307	410	312	409	
301	308	305	302	303	304	108	306	316	406	405	404	402	103	106	482	105	
402	301	304	305	406	405	404	403	401	482	481	480	
227	203	212	204	207	211	209	208	210	206	226	228	205	
316	308	309	318	317	302	303	304	305	306	315	314	482	405	356	355	410	301	409	
412	406	481	305	407	356	410	411	413	484	483	482	409	408	
405	318	301	302	303	304	305	316	106	482	481	406	356	404	410	402	401	403	409	
205	201	203	202	204	207	206	209	208	211	226	227	212	
482	318	356	301	304	305	316	406	405	404	410	481	412	408	409	402	
315	309	318	313	312	311	310	317	305	314	316	356	355	410	484	307	
401	405	404	403	402	481	480	
207	203	212	210	206	209	208	211	228	226	227	205	204	
105	301	102	108	111	110	164	103	101	106	107	104	
305	308	318	304	303	317	316	315	413	484	483	482	481	406	314	356	405	404	410	402	412	301	409	408	
204	201	203	202	205	207	206	209	211	227	
308	309	305	318	304	301	302	303	317	316	306	314	355	307	
355	308	309	318	312	302	303	317	316	306	307	310	315	314	
410	318	304	305	315	316	484	483	482	481	406	414	356	405	411	412	413	409	408	
483	305	414	356	410	411	412	413	484	409	408	
314	308	309	318	313	312	311	310	317	305	315	307	316	356	355	306	
302	308	309	304	301	303	317	316	306	307	355	405	106	
303	308	309	318	301	302	304	316	306	305	355	317	405	106	
101	102	103	106	104	105	
307	308	309	318	312	311	310	317	306	314	355	315	302	
413	481	305	407	356	410	411	412	484	483	409	408	
210	203	202	212	207	211	209	206	228	227	226	
228	212	207	210	211	209	227	226	
103	301	164	108	102	101	106	104	105	
403	407	406	405	404	402	401	408	409	481	480	
110	108	109	111	112	164	107	104	105	
407	406	404	403	411	412	413	409	481	408	
411	407	410	412	413	409	483	481	408	
111	108	109	110	112	164	106	107	104	105	
201	203	202	205	204	206	209	
112	109	111	110	164	107	
310	313	312	311	315	307	355	306	314	
501	595	502	503	
202	201	203	205	204	210	206	209	211	
203	201	202	205	204	207	206	209	210	211	227	
102	164	108	103	101	106	107	104	105	
104	102	108	109	111	110	164	103	101	106	107	105	
164	102	108	109	111	110	112	103	106	107	104	105	
107	102	108	109	111	110	112	164	104	105	
109	111	110	112	164	107	104	
106	301	302	303	304	405	102	108	111	164	103	101	104	105	
108	301	102	111	110	164	103	106	107	104	105	
408	411	305	407	406	404	403	481	412	413	410	483	482	409	
481	401	305	482	480	407	406	405	404	403	402	412	413	410	408	409	411	
356	318	313	304	311	317	316	315	305	314	483	482	484	414	405	410	412	413	312	409	
484	318	305	315	414	356	410	412	413	483	409	
595	502	503	501	
406	301	304	305	407	405	404	410	409	412	403	402	482	481	408	
409	318	304	305	316	484	483	482	481	406	407	356	405	404	410	411	412	413	403	408	
502	595	503	501	
503	595	502	501	
